###############################
#o......MM...................o#
#.######.##.###.###.##.######.#
 .#    #.##.### ###.##.#    #. 
 .#    #.##.#     #.##.#    #. 
#.######.##.#######.##.######.#
#o.........{............MM...o#
###############################
