##########################
#............##..........#
#o####..###..##..###..####
#............}....o......#
#.####.##..######..##.##.#
#......##....##....##....#
#......##          ##....#
######.## ###  ### ##.####
....o..   #  MM  #   ..o.  
######.## ######## ##.####
#......##          ##....#
#......##.########.##....#
#.###..##.########.##..###
#........M...o....M......#
##########################
